9
111111111
100010001
101000001
110000001
100020101
100011001
100000001
100010001
111111111
