6
111111
1    1
101  1
1    1
1    1
111111
